###########
#######TT##
####>TTT###
######BT###
######BT###
###########
###########
